0 0 0 0 0 0 0 0 0 0 0 0 0 0 0
0 0 0 x x x x x x x 0 0 0 0 0
0 x x x 0 0 x 0 0 x x x 0 0 0
0 0 0 x x x x 0 0 0 0 x 0 0 0
0 x x x 0 0 x x x x x x x x 0
0 0 x 0 0 0 x 0 x 0 0 0 0 0 0
0 x 0 0 0 0 x x x x x 0 0 0 0
0 x x 0 0 x x 0 0 x 0 0 x x 0
0 0 x x x x 0 0 x x 0 x x 0 0
0 x x 0 0 x x x 0 x 0 0 x x 0
0 0 0 0 0 0 0 x 0 0 0 0 x 0 0
0 0 0 0 0 x x x 0 0 x x x 0 0
0 x x x x x 0 0 0 x x x 0 0 0
0 0 X 0 0 x x X 0 x 0 0 0 0 0
0 0 0 0 0 0 0 0 0 0 0 0 0 0 0
